1111111111111
10010C1000101
1100010000111
1000000000001
1C11010010C11
1111C10011101
10100000100E1
110001C111001
1000001001001
1000CC0P00001
1100000101001
1000101100111
1111111111111
