111111111111111111111111
1C00000000000000000000C1
100000001100011011100001
100000011000010011100001
100000110000000111000001
10000110000E001110000001
10001100000P011100000001
100111111110011100100001
100000001110011101100001
100000001110000000000001
1C00000000000000000000C1
111111111111111111111111
