111111111111111
1000C0001C00001
1011C1011010001
100000100000101
10C1100C1100101
1000000C1000101
1C1000100100001
100010010100001
10010000011E101
1000000P1CC1001
101000100101001
101010000000001
100111111C01001
10101100100C011
111111111111111
