111111111111111
100000000C00001
100000000000001
100000000000001
100000000000001
100000000000001
100000000000001
100P00000000001
100000000000001
1000E0C00000001
100000000000001
10C0000C0000001
100000000000001
100000000000001
111111111111111
