11111111111111111111111111111111111111111111111111
1C000000000000000000000000E00000000000000000000001
11111111111111111111111111111111111111111111111101
10000000000000000000000000000000000000000000000001
10111111111111111111111111111111111111111111111111
10000000000000000000000000000000000000000000000001
11111111111111111111111111111111111111111111111101
10000000000000000000000000000000000000000000000001
10111111111111111111111111111111111111111111111111
10000000000000000000000000000000000000000000000001
11111111111111111111111111111111111111111111111101
10000000000000000000000000000000000000000000000001
10111111111111111111111111111111111111111111111111
10000000000000000000000000000000000000000000000001
11111111111111111111111111111111111111111111111101
10000000000000000000000000000000000000000000000001
10111111111111111111111111111111111111111111111111
10000000000000000000000000000000000000000000000001
11111111111111111111111111111111111111111111111101
10000000000000000000000000000000000000000000000001
10111111111111111111111111111111111111111111111111
10000000000000000000000000000000000000000000000001
11111111111111111111111111111111111111111111111101
10000000000000000000000000000000000000000000000001
10111111111111111111111111111111111111111111111111
10000000000000000000000000000000000000000000000001
11111111111111111111111111111111111111111111111101
10000000000000000000000000000000000000000000000001
10111111111111111111111111111111111111111111111111
10000000000000000000000000000000000000000000000001
11111111111111111111111111111111111111111111111101
10000000000000000000000000000000000000000000000001
10111111111111111111111111111111111111111111111111
10000000000000000000000000000000000000000000000001
11111111111111111111111111111111111111111111111101
10000000000000000000000000000000000000000000000001
10111111111111111111111111111111111111111111111111
10000000000000000000000000000000000000000000000001
11111111111111111111111111111111111111111111111101
10000000000000000000000000000000000000000000000001
10111111111111111111111111111111111111111111111111
10000000000000000000000000000000000000000000000001
11111111111111111111111111111111111111111111111101
10000000000000000000000000000000000000000000000001
10111111111111111111111111111111111111111111111111
10000000000000000000000000000000000000000000000001
11111111111111111111111111111111111111111111111101
10000000000000000000000000000000000000000000000001
10111111111111111111111111111111111111111111111111
10000000000000000000000000000000000000000000000001
11111111111111111111111111111111111111111111111101
10000000000000000000000000000000000000000000000001
10111111111111111111111111111111111111111111111111
10000000000000000000000000000000000000000000000001
11111111111111111111111111111111111111111111111101
10000000000000000000000000000000000000000000000001
10111111111111111111111111111111111111111111111111
100000000000000000000000000000000000000000000000P1
11111111111111111111111111111111111111111111111111
