11111111111111111111111111111111111111111111111111
100111100010001101000001C0000001010111111000100101
11010C1001010100CC1010100010100010000000000000C001
10C10100011000000001010100001000100000011110C10001
1010001000100C01000111100CC0010011001111000010C101
11C00011C00C000C0110001100110010010100001010101001
100001000010000101111011C0100001000111000101001001
100010010100001000100010000000000000C1000101000C01
10100001000000C11100100000010011000000101001000101
1011010001C101001010C00001C00100000011001000000001
11100001000100011000C00100000101000010C0C1000C1101
1C000001010000001010000100111011000000100010010101
111010100000000C00010100E0010000000101011001000011
10101000CC10001C11001000011000000100C011000001C001
10000001000010000001010001000000001001111100000001
10C1010000000100C10C0001010C0000010000110001010111
1000000100011100010C00000C0011000100000C0110101101
1000000000011000010C0010100001000C1000100100001011
100111010100011001000000000010010010C0110101000101
10000010000001010000010001000001000010C00000011101
100010C000100000010000010001101010100010001C000001
100110010000001C0001C01000000010000000101010011001
1100C100000000100001010000001100101100C00C1C000001
101001001000C0010001000000011110010100000010010001
100C1100100000010000011101110001100010010001000101
10000000100011011100000010000000000010101000011111
1000110C000010010C00000010111100000011100001010101
110110010000C00001000011110C110111100001000100C011
110000100110000100C100000100111CC00001000010001101
111010000C0000001000100000000001100010100101010001
10010000010000101001000110P0101110001C001101010001
1C10C001000C00000000100000010101000011000110000001
11010010111110000000000C00001100110000100010000001
10010100010001000010001000001110001100000C10010001
100001000000101C0101000010100000C00100000000100001
11000000000101100001010001100001101C0110000C000101
1C100010001010011010000C10110011011000C00000001001
110C101000001001100001010000101000C1C1011000000001
1010C101111010001001000000000010001000000111010C01
1001011101000010010000C01C00C000001000100100C00001
100000110000000000100110001001010000000C0000000001
1001100110011000110100C001110000011001001011001111
110100001000000CC10C0000100000110000110C0011001111
110100000010010000010000001110010100010C0010000001
101000100000C0000110000000000010100101011001100001
100000010010100010010100000010C0C000000011001C0111
10000C100000110C0000000011110000010110000011010001
100100011000010101111010001001C0011101010000010101
10000101010011C1000100100000C100001001000000000001
11111111111111111111111111111111111111111111111111
