111111111111111111111111111111
1000000000000000C0000000000001
10C0000000000000C0000000000001
100000000000000000000000000001
100000000000000000000000C00001
1C0000000000000000E0C000000P01
1000000C0000000000000000000001
100000000000000000000000000001
1010000000C0000000000000000001
111111111111111111111111111111
