11111
1CPC1
1EC11
11111
11111
11111
