1111111111
10C0111001
100001EC01
1C01000111
1100000101
1100100001
1000110001
100011P001
1010010111
1111111111
