111111111111111111111111
100000000000000000000001
100000001100011011100001
100000011000010011100001
100000110000000111000001
10000110000E001110000001
100011C00000011100000001
100111111110011100100001
100000001110011101100001
100000001110000000000001
1000000000000000P0000001
111111111111111111111111
