1111111111111111111111111111111111111111111
1000100100000010000010000101001000100010001
1001001000011C110001E1110000100110100000001
110001100000001010100C1011110010100010C1101
10CC0C010010001C01000000000C100001000000001
1101100000011000010000010100001100100001001
11110000011100000001011000C0C0C100100000C01
1100000000010100011001000000011000C00001001
10011011010110100C01C000C110010100100011001
1C1010001C000101011111010010011111010011011
1000001110000110000000101010100010000000111
10C000000000010010C000000011010C11000000011
10001010000001000C10001100000001001C0000001
1110100010010101100001000010000000101100001
10001010101010C001000C000000000100010000111
11001011000000000000011C00001010000C0100001
100000010000000001C11000C010000001C10111001
1100001000011000011110111000111000101110001
10000110001001011C00001000000C0101100100001
10011110000000000110101000C0001010C10100001
10101010000001C0000001011000010000111100001
1100001001000001P1C00001100C000010010000111
1111111111111111111111111111111111111111111
