1111111111
1001000101
1000P01111
1100000101
1010000001
1000000001
1001010001
1000000101
1000010001
1111111111
