1111111111
1000111E11
1C00PC1001
1000011001
10C0101101
1000001011
1010000001
1011100101
1100100011
1111111111
