1111111111
1000001011
101C111101
1001011111
1001000101
1000101001
1100101011
110E010001
1P00100001
1111111111
